++++++++++++++++++++++
+           ++++++++++           
+ +++++++++           
+ + ++ ++++ +++ ++++++    
+ +  +       + +      
+ ++ ++ + +    +      
+     + + ++ + +      
+++++ ++++++++++ +    
+++++ S+ + +          
+++++ +++++++++++     
++++++++++++++++++++++