++++++++++++++++++++++
+ + ++ ++ ++++++++++++           
+ +++++++++           
+ + ++ ++++ +++ ++++++    
+ +          + +      
+ ++ ++ + +    +      
+     + + ++ + +      
+++++ +++ + + ++ +    
+++++ S+ + +          
+++++ + + + + + +     
++++++++++++++++++++++